111111111111111
100000000000001
1000000000P0001
10000E000000001
1000000000C0001
111111111111111
